Lmao -> Lmao
lmao -> lmao
penis -> penis hihi
Penis -> Penis hihi
Sieg -> 𝕳𝖊𝖎𝖑
Niklas stinkt -> Das stimmt!
Johannes stinkt -> Du stinkst selber, du Hund
Marek stinkt -> Marek ist super!
Max stinkt -> Nich so schlimm wie du!
Bli -> Bla
Bla -> Blo
Blo -> Blu
Blu -> Bli
Bla -> Blub
Hallo -> Hi
All I want for christmas -> Is youuuuuuuuu
69 -> Nice
69420 -> Nice
69 420 -> Nice
Hi -> Wal
nice -> nice
amongus -> amongus
Amongus -> Amonugs
AMONGUS -> AMONGUS
test12321 -> 12321
from_test_server -> works
johannes... -> ...ist richtig goil
noice -> NOICE
goil -> goil
was? -> ab geeeehhhtss!!!!
Niklas... -> ~~Niklas~~ Daddy!
JoBändi -> HooyeeaaaAAAAAAAAAAAAAAAA
bruh -> bruh
Bruh -> Bruh
lol -> bRuH
BRUH -> BRUH
-.- -> -_-
-_- -> -.-
:3 -> :3
:3 -> uwu
uwu -> :3
XD -> 😂
dafuq -> the *FUCK*
Marek stinkt -> Der stinkt wie Sau!
jo -> jo
bread -> bread
big brain -> 🧠
ich liebe Baumbot -> ich liebe dich auch💋
*kotzgeräusch* -> 🤢 🤮
oke -> okeee
i like -> me too
gut -> 👍🏿
schee -> RICHTIG WUNDERSCHÖNER UND KRASSER SHIT
nioce -> nIOceE
dang -> damn
rip -> Rest In Pizza
damn -> oh dang boiiii
test_multiple -> A
test_multiple -> B
test_multiple -> C
test_multiple -> D
bitte -> bidebide
👍🏿 -> 👍🏿
👍🏿 -> 👍
jo -> joooooooooo
xd -> 😄
lamo -> Dick Move
amongus -> ඞ
ich hasse baumbot -> gemein...
ma boii -> MA BOIIIIIII
Johannes -> 🥵
